An Giang: AG
Bà Rịa - Vũng Tàu: BV
Bắc Giang: BG
Bắc Kạn: BK
Bạc Liêu: BL
Bắc Ninh: BN
Bến Tre: BT
Bình Định: BĐ
Bình Dương: BD
Bình Phước: BP
Bình Thuận: BTh
Cà Mau: CM
Cao Bằng: CB
Đà Nẵng: ĐNa
Đắk Lắk: ĐL
Đắk Nông: ĐNo
Điện Biên: ĐB
Đồng Nai: ĐN
Đồng Tháp: ĐT
Gia Lai: GL
Hà Giang: HG
Hà Nam: HNa
Hà Nội: HN
Hà Tĩnh: HT
Hải Dương: HD
Hậu Giang: HGi
Hòa Bình: HB
TP HCM: SG
Hưng Yên: HY
Khánh Hòa: KH
Kiên Giang: KG
Kon Tum: KT
Lai Châu: LC
Lâm Đồng: LD
Lạng Sơn: LS
Lào Cai: LCa
Long An: LA
Nam Định: ND
Nghệ An: NA
Ninh Bình: NB
Ninh Thuận: NT
Phú Thọ: PT
Quảng Bình: QB
Quảng Nam: QNa
Quảng Ngãi: QNg
Quảng Ninh: QN
Quảng Trị: QT
Sóc Trăng: ST
Sơn La: SL
Tây Ninh: TN
Thái Bình: TB
Thái Nguyên: TNg
Thanh Hóa: TH
Thừa Thiên Huế: TTH
Tiền Giang: TG
Trà Vinh: TV
Tuyên Quang: TQ
Vĩnh Long: VL
Vĩnh Phúc: VP
Yên Bái: YB
Phú Yên: PY
Cần Thơ: CT
Hải Phòng: HP